l̬um	liom	avec moi
flⁱuĉ	fliuch	mouillé, humide
qilā́n	cuileán	jeune chien
qiŝlán	caisleán	château
tᵘeršạĉ	tuirseach	fatigué
bon-āt̬	bunáit	principale résidence, fondation
múⁱnt̬óⁱr	múinteóir	professeur
drifⁱúr	deirbhshiur	sœur
emedạ̄́n	amadán	un fou
màonteĉạ̄́n	manntachán	qui a les dents ébréchées
O’ Sùleƀáⁱn	O’ Súilleabháin	nom propre
clieƀạ̄́n	cliabhán	berceau
baləƀạ̄́n	balbhán	muet
begạ̄́n	beagán	un peu, peu
qịlạ̄́n	cuileán	jeune chien
berạ̄́ne/brā́n	biorán	épingle, un rien
bredạ̄́n	bradán	saumon
qišlạ̄́n	caisleán	château
pǫrtạ̄́n	portán	crabe
erạ̄́n	arán	pain
cupạ̄́n	cupán	coupe
ẹlạ̄́n	oileán	île
scạ̄hạ̄́n	scáthán	mirroir, à côté de
scehā́n	scathán	buisson
mọ̄rā́n	mórán	beaucoup
awrā́n	abhrán	poème, chant
bǫĉtā́n	bochtán	un pauvre
capelī́n	capaillín	petit cheval
laneƀī́n	leanbhín	petit enfant
cąlī́n	cailín	fillette
gertī́n	guirtin	petit champ
trehī́n	troighthín	petit pied
ạyntī́n	aintín	tante
spalpī́n	spailpín	journalier, laboureur errant
crūšcī́n	crúiscin	cruche
cábī́n	cáibín	vieux chapeau
drōlī́n	dreoilín	roitelet
bǭrhī́n	bóithrín	petit sentier
trāʰnī́n	tráithnín	brin d’herbe
crīƀī́n	craoibhin	petite branche
fįn̬ọ̄́g	fuinneóg	fenêtre
fwīn̬šọ̄́g	fuinnseóg	frêne
cesọ̄́g	casóg	veston
fwišọ́g	fuiseóg	alouette
išó̦g	an fhuiseóg	l’alouette
qīnlọ̄́ir	coinnleóir	chandelier
dlīdǫ́ir	dligheadóir	homme de loi
múⁱntǭ́ⁱr	múinteóir	professeur
āęršoⁱr	aidhbheirseóir	l’adversaire (le diable)
slānehǭ́ⁱr	slánuightheóir	le sauveur
šc̬ebǭl	sgioból	grenier
mįnạ̄́l	muineál	cou
cahī́r	cathaoir	siège
enạ̄́l	anál	haleine
cimā́d	coimeád	garder, protéger
lęhẹ̄́d	leithéid	espèce, sorte, de cette sorte
mecā́ntœĉt	macántacht	honnêteté
lùescā́nœĉ	luascạ̄́nach	instable, remuant
slā́her	soláthar	provisions, aller aux provisions
felā́ⁱn	folláin	sain, salubre
crṓⁱn	coróin	couronne (pièce de monnaie), règne d’un roi
ūlṓⁱd	umhlóid	humilité
begā́nī̀n	beagáinín	un petit peu
calī́nī	cailínidhe	fillettes
rǫhā́nīn	rotháinín	petite roue
mərcáĉ	marcách	cavalier
márcig	márcaigh	[de cavalier]
Mw̄n	Mumhan	Munster
Tuə-mūn	Tuath-mhumhan	Thomond, Nord-Munster
Dąs-vw̄n	Deas-mhumhan	Desmond, Sud-Munster
ur-vw̄n	Ur-mhumhan	Ormond, Est-Munster	Urmhumhan
Ervūn	Or-mhumhan	Ormond, Est-Munster
Iar-vūn	Iar-mhumhan	Ouest-Munster
rᵘí	[rí]	roi
nī́nān	naoidheanán	petit enfant	naíonán
ūmpọ/ōmpọ	iompodh	action de tourner	iompú
pārdún	[pardún]
cābọ̄g̬īn	cábóigín	vieux-chapeau, rustre
qīnšī́ᵉs	coinsías	conscience			Henebry (Sounds, p. 14) : kawnšīs
pᵉlẹ̄́r	peiléar	pilier
pālā́s	pálás	palais
sọ̄lā́s	sólás	satisfaction, consolation
bagū́n	[bagún]	lard		OFr: bacōn
garsū́n	garsún	garçon
cabáštẹ	cabáiste	choux
cọlā́štẹ/clā́štẹ	coláiste	collège
perṓštẹ	paróiste	paroisse
ọráštẹ	oráiste
ə gōnī	i gcomhnuidhe	habituellement
stawmpwī	stampaidhe	timbres-poste
šīmplī	simplidhe	simple, niais
díanī̀	déidheanaighe			le déidheanaighe, dernièrement, récemment
ẹrī́ĉt	aeraidheacht	promenade d’agrément, divertissement en plein air
ànəƀī́ĉt	ainmhidheacht	bestial, brutal
c̬ạnī́ĉt	ceannuigheacht	action d’acheter
cǫšīĉt	coisidheacht	voyage à pied, aptitude à bien marcher
qīnī́ĉt	cuimhnigheacht	se rappeler
fǫsī́ĉt	fosuigheacht	terre à pâture
īqī́ĉt	iocaidheacht	tenir une ferme
marqīĉt	marcaidheacht	aller à cheval
šc̬ìalī́ĉt	scéalaidheacht	conte, récit, action de raconter
bihū́nœĉ	bitheamhnach	voleur, malfaiteur
brehū́nes	breitheamhnas	jument, décision du juge
calū́nœĉ	cailleamhnach	qui perd
fǫlū́nœĉ	follamhnach	qui soutient
šc̬ęnū́nœĉ	sceinneamhnach	qui s’agite, étourdi
ẹrū́nœĉ	oireamhnach	opportun, convenable
c̬ąnū́lœĉt	ceanamhlacht	affection
cesū́lœĉt	cosamhlacht	ressemblance
fọ̄rtū́lœĉt	fortamhlacht	force
fląhū́nes	flaitheamhnas	royaume, domination
g̬ąlū́ⁱnt	geallamhaint	promesse, apparence (pour le temps, par exemple)
lęšc̬ū́ⁱl	leisceamhail	paresseux, indolent
fạrū́ⁱl	fearamhail	viril
bąnū́ⁱl	beanamhail	comme une femme, modestement
diəgᵉsū́ⁱl	diadhasamhail	dévot
ìagəsū́lœĉt	éagsamhlacht	diversité, différence
lānūⁱn	lánamhain	couple marié
dąrūd	dearmhad	oubli
sū talū́n	sugha talmhan	fraises
bənūs	bunadhas	origine, fondement
bənū́sœĉ	bunadhasach	primitif, qui est à l’origine
c̬arū́ĉ	cearrbhach	joueur de profession
šąrū́s	searbhas	amertume
arū́r	arbhar	blé
g̬alū́n	gealbhan	moineau
bąrī́n	bairghean	gâteau, pain
bawrī́n	bainríoghain	reine
mwirī́n	muirighin	fardeau, famille nombreuse à nourrir
fątī́s	faithchios	peur
dǫlī́s	doilgheas	affliction, chagrin
cūntū́īⁱrt	contabhairt	doute, risque		génit. cuntūrʰe (contabhartha)
inīen	inghean	fille
əmyọ̄d	imtheochad	je m’en irai		1re pers. du fut. ind.
dəlū́r	duilleabhar	feuillage
stǫqī	stocaidhe	plur. de stoca, bas, chaussette
pąqī	peacaidhe	péchés
g̬ąlī	[gealaidhe]	la lune		gén. de gealach
tąsī́	tasuighe	chaud
Córqįg	Corcaigh	Cork
Córqī		Cork		génitif : nom. sg. Córqįg (Corcaigh)
prātī́	prátaidhe	pommes de terre
pāštī́	pastaidhe	enfants
bāištī́	baistighe	ondées de pluie
šīmplī	simplidhe	simple, un peu niais		Henebry (Sounds, p. 24, 4) : šaimplī
sərī́	suirghe	action de courtiser
ẹyrī́	éirghe	lever, se lever
dęrənī́	deireannaighe	le deireannaighe, récemment
cǫmərī	comraidhe	protection
ə gônī	i gcomhnuidhe	habituellement
dīanī	déidheanaighe	le déidheanaighe, dernièrement
stạ̃wmpwī	stampaidhe	timbres-poste
bęrū́	bearbhadh	bouillir
bąlū́	bailiughadh	ramasser, économiser
àhərū́	athrughadh	changer
fįsərụ́	fiosrughadh	s’informer
mą̀həlū	meathlughadh	défaillir, faiblir
baləƀū́	balbhughadh	faire taire, rendre muet
qīnū́	cuimhniughadh	rappeler
c̬ąrū́	ceathramhad	quatrième
trī́ū	tríomhadh	[troisième]
cūg̬ū	cúigmhadh	cinquième
šḗū	sémhadh	sixième
šąĉtū	seachtmhadh	septième
ǫ́ĉtū	ochtmhadh	huitième
nẹ̄́u	naomhadh	neuvième
calī́nī óge	cailínidhe óga/cailíní óga	jeunes filles
ágerhœĉ	agarthach	vindicatif
áherœĉ	atharrach	changement
bágeroe	bagarach	menaçant
báhelœĉ	bathalach	hutte, maison mal construite
brǫhelœĉ	brothalach	très chaud, brûlant (en parlant de la température)
cog̬elhœĉ	coigealtach	économe
cáradœĉ	caradach	amical
pǫhernœĉ	putharnach	action de souffler
rágernœĉ	ragairneach	inconstant
rīəĉtenœĉ	ríachtanach	une personne nécessiteuse
Sásenœĉ	Sasanach	Anglais
clágernœĉ	clagarnach	pluie battante
dẹ́renœĉ	deireannach	dernier, tard
Erenœĉ	Eireannach	Irlandais
g̬ą́nesœĉ	geanasach	modeste
g̬ebelœĉ	giobalach	déguenillé, déchiré (en parlant des vêtements)
męg̬elœĉ	meigeallach	barbu, barbu comme un bouc
mogelœĉ	mogallach	luxuriant (en parlant de cheveux), touffu
mǫrsenœĉ	mursanach	tyrannique
scrupelœĉ	scrupalach	scrupuleux
árᵊmœĉ	armach	belliqueux
bácᵊlœĉ	baclach	grand nombre de gens
bǫlᵊgœĉ	bolgach	ampoule, pustule ; id. (adjectif) : qui a un gros ventre
cą́dərœĉ	caidreach	amical
cąlegœĉ	cailgeach	piquant, armé de piquants
c̬ą́lᵊgœĉ	cealgach	trompeur
c̬ąngelœĉ	ceanglach	lien, attache
c̬arebœĉ	cearbach	en guenilles, galeux
cǫlegœĉ	colgach	pointu
cráhərœĉ	crathrach	fondrière
criəʰrœĉ	criathrach	marais
dąləƀœĉ	dealbhach	beau
dąləgœĉ	dealgach	épineux
dąrəƀœĉ	dearbhach	sûr, que l’on peut prouver
ẹ́tərœĉ	eitreach	sillon ; ancien adjectif : sillonné
fíacəlœĉ	fiaclach	qui a de grandes dents
gálərœĉ	galrach	malade (adj. et subst).
g̬ąrəbœĉ	gearbach	couvert de croûtes
gǫbəlœĉ	goblach	bouchée
lę́rəgœĉ	leargach	en pente, à pente rapide
lįbərœĉ	liobrach	aux lèvres épaisses
mąscəhœĉ	meascthach	qui se mêle facilement
mǫcəloech	muclach	troupeau de porcs
níaƀərœĉ	niamhrach	brillant
tǫ́ləgœĉ	tolgach	orgueilleux
frę́əhœĉ	fraochach	couvert de bruyère
g̬iagœĉ	géagach	qui a des branches
gnī́ƀœĉ	gníomhach	actif
íạscœĉ	iascach	poissonneux
líəhœĉ	líathach	pâle, blême
lū́bœĉ	lúbach	qui plie, au moral, subtil
šc̬íaƀœĉ	scíamach	beau
brẹ́ənœĉ	braonach	humide, qui tombe goutte à goutte (se dit aussi des larmes)
bríagœĉ	bréagach	menteur, mensonger
ī́lœĉ	aoileach	fumier
ẹ́ᵉnœĉ	aonach	foire, assemblée
ā́rœĉ	árach	garantie, secours
bíətœĉ	biadhtach	qui nourrit (les pauvres), hospitalier
bī́gœĉ	bíodhgach	vigoureux (en parlant de la voix)
búəcœĉ	buacach	qui a la tête haute, fier
cᵃẹ́bœĉ	caobach	grossier, gauche
cᵃẹ́lœĉ	caolach	linum silvestre, jeune plant
clúəsœĉ	clúasach	qui a l’oreille paresseuse
crᵃẹ́sœĉ	craosach	avide
fúədœĉ	fuadach	action de piller, d’enlever de force
scúəbœĉ	scuabach	qui balaie, qui brosse
tᵃę́ƀoech	taobhach	latéral, qui a des côtés (au moral ; qui a du goût, de l’inclination pour)
tī́šœĉ	taoiseach	chef, commandant
tṓrᵊmœĉ	tórmach	accroissement
túətœĉ	tuatach	rustique, gauche
úəlœĉ	ualach	fardeau
úənœĉ	uamhnach	craintif
šū́lœĉ	siubhlach	voyageur (au sens adj. : rapide)
tī́lœĉ	teimhleach	obscur
qī́lœĉ	coinnleach	chaume
min-ū́rœĉ	min-iubhrach	cruche
g̬īlœĉ	geimhleach	tenu en esclavage
cū́dœĉ	cumhdach	action de couvrir
šáwrœĉ	seabhrach	courageux, vigoureux
mẹ́wloec̬	meabhlach	trompeur
nī́nœĉ	neimhnach	venimeux
cáwlœĉ tī	cabhlach tighe	maison vide
gáwlœĉ	gabhlach	fourchu
máwntœĉ	manntach	qui a les dents ébréchées
qī́ltœĉ	coillteach	boisé
õmplœĉ	amplach	avide
g̬ą̄́rcœĉ	gearrcach	oisillon
šlīn̬tœĉ	slinnteach	ardoises, tuiles
blą́ĉtœĉ	bleachtach	vache à lait
cą́ilc̬œĉ	cailcach	crayeux
flą́scœĉ	fleascach	jeune homme
láyrœĉ	laidhreach	ayant de gros doigts de pied
lọ́ĉtœĉ	lochtach	fautif
máng̬œĉ	meangach	subtil, trompeur
fǫ́lʰœĉ	foltach	chevelu
scǫ́lʰœĉ	scoilteach	bois qui se fend
šą́sc̮œĉ	seascach	vache stérile
sẹ́sc̬oec̬	seascach	abondant en joncs
tǫ́ĉtœĉ	tochtach	silencieux
trǫ́scœĉ	troscach	qui jeûne
úĉtœĉ	uchtach	sein
ū́ltœĉ	Ultach	homme d’Ulster
fǫ́rtœĉ	feartach	actif, énergique
gǫ́rtoec	gortach	qui a faim
stalcœĉ	stalcach	raide, entêté
scertáĉ	scairteach	fourré, taillis
portáĉ/pertáĉ	portach	marais
fǫrcáĉ	forcach	fourchu
mercáĉ	marcach	chevalier, qui va à cheval
g̬elcáĉ	giolcach	espèce de roseaux qui pousse dans un marais
tᵘoeršą́ĉ	tuirseach	fatigué
cną́sœĉ	cneasach	à écorce ou à peau
cnǫ́cœĉ	cnocach	montagneux
snǫ́sœĉ	snosach	lustré
slǫ́gœĉ	slogach	abondant en trous
scágœĉ	scágach	qui fuit, qui fait eau
smógœĉ	smugach	qui a l’habitude de cracher
spᵉedáĉ	spadach	plein de mottes
cáhœĉ	cathach	frisé, bouclé
clą́hoec	cleathach	à côtes, fait d’entrelacs
cléhœĉ	cluicheach	qui aime le jeu, qui joue des tours
cráhœĉ	crathach	qui agite, remue
crǫ́hœĉ	cruthach	bien fait, bien bâti
fáhœĉ	fathach	géant
grǫ́hœĉ	gruthach	caillé
c̬ą́hœĉ	ceathach	à ondées
gǫ́hœĉ	gothach	retentissant, qui répond
šc̬ą́hœĉ	sceathach	couvert de buissons, touffu
sclạ̃ĉ	sclamhach	avide
úenœĉ	uamhnach	peureux
tráwĉ	treabhach	un laboureur
lã́ĉ	làmhach	action de tirer
dáwĉ	dabhach	vase
cũəĉ	cumhach	affligé
fiəĉ	fiadhach	action de chasser
blạ̃ĉ	bladhach	renommé
lạ̃ĉ	laghach	aimable, obligeant
becạ́ĉ	bacach	boiteux, estropié, mendiant
clₑbạĉ	clabach	aux lèvres épaisses
bₑlạĉ	bealach	route
bįšąĉ	biseach	accroissement
bₑgáĉ	bogach	mou, tendre
bǫgạĉ	bogach	marais
bₑrą́ĉ	biorach	épingle
brₑtạĉ	bratach	étendard, robe
brₑmą́ĉ	bromach	poulain
qilạ́ĉ	cailleach	sorcière
c̬įmạ́ĉ	ciomach	torchon, personne malpropre
brₑdáĉ	bradach	porté à de menus larcins
brₑlạ́ĉ	breallach	noueux
brǫlạ́ĉ/brₑláĉ	brollach	sein
c̬ₑtáĉ	ciotach	gaucher
c̬ịšạ́ĉ	ciseach	chaussée
qįlą́ĉ	coileach	coq
cǫlą́ĉ	cullach	verrat
cₑrạ́ĉ	corach/corrach	marais
drǫmạ́ĉ	dromach	courroie avec agrafes ou boucles que l’on passe par-dessus la croupe du cheval attelé à la charrue
ₑrạ́ĉ	earrach	printemps
ₑsạ́ĉ	easach	chute d’eau
fₑlą́ĉ	folach	action de cacher, caché (subst. et adj.)
fįsą́ĉ	fiosach	qui connaît, intelligent
g̬ąlą́ĉ	gealach	la lune		génitif g̬ąlī́ (gealaighe)
crₑsą́ĉ	crosach	rayé, croisé
dₑsą́ĉ	dosach	touffu, qui a des buissons
frₑsą́ĉ	frasach	à ondées, productif
g̬ₑbą́ĉ	giobach	velu, rugueux
glₑbạ́ĉ	gliobach	chevelu, à longs cheveux
glįšạ́ĉ	glaiseach	fondrière
grₑlą́ĉ	greallach	argile, terre glaise
lₑcą́ĉ	leacach	abondant en pierres plates
mₑrcạ́ĉ	marcach	cavalier
pₑcaĉ	peacach	pécheur
prₑšą́ĉ	praiseach	potage
slạ́ĉ	salach	sale
šₑrạĉ	searrach	poulain
šₑmą́ĉ	siomach	truite ressemblant à une anguille, se dit d’un homme grand et mince
šₑną́ĉ	sionach	renard
nₑdạ́ĉ	neadach	qui appartient, se rapporte à un nid
gₑbạ́ĉ	gobach	à bec
gₑrœ́ĉ	gorach	inflammable
tǫlạ́ĉ	tollach	troué
tₑsạ́ĉ	tosach	commencement
trₑdạ́ĉ	troideach	querelleur, combattif
mǫ́gœĉ	mugach	adonné aux plaisanteries
mášœĉ	maiseach	beau
ₑgúm	agam	avec moi
ₑgút	agat	avec toi
bukách	bacach	un boiteux
bákuch	bacach	boiteux, qui boite
mǫ́le	moladh	louer
mǫlög	moladh	louer
cₑsaĉt	casacht
cₑsạĉtaœĉ	casachtach	toux
bₑnaĉt	beannacht	bénédiction
mₑlaĉt	mallacht	malédiction
qidaĉtin	cuideachtain	compagnie
áĉin̬ẹ̄	ath-chuinghe	requête, demande
áhəriš	aith-ris	action d’imiter, relater
áhənẹ	aithne	connaissance, action de reconnaître
áĉomęr	ath-comair	près
áƀrišₑ	aith-bhriseadh	je brise de nouveau
aƀę́ᵉlœĉ	aidh-bhéileach	très grand, extraordinaire
áĉianǫv	aith-dhéanam	refaire
alī́nₑ	aith-líonadh	remplir de nouveau
avíalₑ	aith-méala	regret
avā́r	ath-bharr	une deuxième récolte
ąnᵊƀis	ain-bhfios	ignorance
ąn̬iš	aindeis	peu soigné, misérable, gauche
án-yąrt	ancheart	injuste
íádrǫm	éadtrom	léger
an-ī́vin̬	an-aoibhinn	déplaisant
àn-ĝā́	an-ghábhadh	inutile
ánəĉrī́	anchroidhe	malveillance
anǭlā́ⁱn	an-fhollàin	malsain
ìagṓₑr	éagcóir	injustice, iniquité
ęgrī́ne	éig-críonna	non sage, imprudent
ągₑnẹ	aigne	intention, esprit
ąspe	easbaidh/easba	manque, besoin
ąsnǭƀ	easnamh	manque, insuffisance
ąscárdẹ̄	eascáirde	ennemis	sg. ą́scere (eascara)
ą́scere	eascara
ąsṓrdū	eas-ordughadh	désordre
ąsūle	easumhla	désobéissance
ąslā́n	easlán	mal portant
ąsláintẹ	easláinte	mauvaise santé