Владимир → Vladimir
Борис → Boris
Смирнов → Smirnov
Сергей → Sergueï
Георгий → Gueorgui
Новгород → Novgorod	
Менделеев → Mendeleïev
Чехов → Tchekhov
Дмитриев → Dmitriev
Ельцин → Eltsine
Дудаев → Doudaïev
Екатеринбург → Iekaterinbourg
Васильев → Vassiliev
Тургенев → Tourgueniev
Пётр → Piotr
Королёв → Koroliov
Горбачёв → Gorbatchev
Нижний → Nijni
Казимир → Kazimir
Михаил → Mikhaïl
Мир → Mir
Достоевский → Dostoïevski
Грозный → Grozny
Алексей → Alekseï
Андрей → Andreï
Александр → Aleksandr
Калининград → Kaliningrad
Малевич → Malevitch
Дума → Douma
Гагарин → Gagarine
Солженицын → Soljenitsyne
Магадан → Magadan
Байконур → Baïkonour
Волга → Volga
Спутник → Spoutnik
Самара → Samara
Новосибирск → Novossibirsk
Курск → Koursk
Владивосток → Vladivostok
Ульянов → Oulianov
Туполев → Tupolev
Прокофьев → Prokofiev
Михаил → Mikhaïl
Хабаровск → Khabarovsk
Цветаева → Tsvetaïeva
Черненко → Tchernenko
Пушкин → Pouchkine
Щедрин → Chtchedrine
Черномырдин → Tchernomyrdine
Область → Oblast'
Элиста → Elista
Биюлин → Biouline
Нефтеюганск → Nefteïougansk
Юрий → Iouri
Союз → Soyouz
Мария → Maria
Майя → Maïa
Маяковский → Maïakovski
Ярославль → Iaroslavl
Ялта → Yalta